15
18
0 5 3 3 3 6 0 0 0 0 0 0 0 0 0 
0 5 3 3 3 6 0 0 0 0 0 0 0 0 0 
0 5 3 3 3 6 0 0 0 0 0 0 0 0 0 
0 5 3 3 3 6 0 0 0 0 0 0 0 0 0 
0 5 3 3 2 6 0 0 0 0 0 0 0 0 0 
0 5 3 3 3 6 0 0 0 0 0 0 0 0 0 
0 5 3 3 3 6 0 0 0 0 0 0 0 0 0 
0 5 3 3 3 6 0 0 0 0 0 0 0 0 0 
0 5 3 3 3 6 0 0 0 0 0 0 0 0 0 
0 5 2 2 7 6 0 0 0 0 0 0 0 0 0 
0 0 0 0 0 0 0 0 0 0 0 0 0 0 0 
0 0 0 0 0 0 0 0 0 0 0 0 0 0 0 
0 0 0 0 0 0 0 0 0 0 0 0 0 0 0 
0 0 0 0 0 0 4 4 4 0 0 0 0 0 0 
0 0 0 0 0 5 3 3 3 6 0 0 0 0 0 
0 0 0 0 0 5 3 3 3 6 0 0 0 0 0 
0 0 0 0 0 5 3 3 3 6 0 0 0 0 0 
0 0 0 0 0 5 3 3 3 6 0 0 0 0 0 
