1217
8
22 4 21 21 21 21 21 21 21 21 21 21 21 21 21 21 21 21 21 21 21 21 21 21 21 21 21 21 21 21 21 21 21 21 21 21 21 21 21 21 21 21 21 3 22 22 22 22 22 22 22 22 22 22 22 22 22 22 22 22 22 22 22 22 22 22 22 22 22 22 22 22 22 22 22 4 21 21 21 21 21 21 21 21 21 21 21 21 21 21 3 22 22 22 22 22 22 22 22 22 22 22 22 22 22 22 22 
22 4 21 21 21 21 21 21 21 21 21 21 21 21 21 21 21 21 21 21 21 21 21 21 21 21 21 21 21 21 21 21 21 21 21 21 21 21 21 21 21 21 21 21 18 22 22 22 22 22 22 22 22 22 22 22 22 22 22 22 19 17 17 17 17 17 17 17 17 17 18 22 22 22 22 4 21 21 21 21 21 21 21 21 21 21 21 21 21 21 21 18 22 22 22 22 22 19 17 17 17 17 17 17 17 18 22 
22 4 21 21 21 21 21 21 21 21 21 21 13 21 21 21 21 21 14 21 21 21 21 21 21 21 21 21 21 21 21 21 21 21 21 21 21 21 21 21 121 21 21 21 21 17 17 17 18 22 22 22 22 22 22 22 22 22 22 22 4 21 21 16 21 21 21 21 21 21 21 17 18 22 22 4 21 21 21 21 21 21 21 21 21 21 21 21 21 21 21 21 18 22 22 22 22 4 21 21 21 21 21 21 21 3 22 
22 4 21 21 21 21 21 21 21 21 21 21 21 21 21 11 21 21 21 21 21 21 21 21 21 21 21 21 21 21 21 21 21 21 11 21 21 21 21 23 24 25 21 21 21 21 21 21 21 17 17 18 22 22 22 22 22 22 22 19 21 21 121 21 11 21 21 21 21 21 21 21 21 17 17 21 21 21 21 9 21 21 21 21 1 21 2 21 21 21 21 21 21 18 22 22 22 4 21 21 21 21 21 21 21 3 22 
22 4 21 21 21 12 21 21 21 21 21 21 11 1 21 21 2 21 21 21 21 21 21 21 21 21 21 15 21 21 21 21 21 23 25 21 21 21 21 21 21 21 21 21 21 9 11 21 21 21 21 21 17 17 17 17 17 17 17 21 21 1 21 21 21 2 21 21 21 21 21 21 21 21 21 21 21 21 21 23 24 25 21 21 3 22 4 21 21 21 21 21 21 21 18 22 22 4 21 21 21 21 21 21 21 3 22 
22 4 21 21 21 21 21 21 21 21 1 21 21 21 6 22 4 21 21 21 21 21 121 9 21 21 21 21 21 21 121 21 21 21 21 21 21 11 21 21 21 21 21 1 21 21 21 21 2 21 21 21 9 21 21 21 21 9 21 21 21 3 22 22 22 4 21 21 21 21 21 21 21 21 21 21 21 21 21 21 21 21 21 21 3 22 4 21 21 21 21 21 21 21 21 17 17 21 21 21 21 21 21 21 21 3 22 
22 4 9 21 121 21 21 21 21 11 3 22 22 22 22 22 4 21 21 21 1 21 21 21 21 2 21 21 9 1 21 21 2 21 9 1 21 21 2 21 21 21 21 3 22 22 22 22 4 121 21 1 21 2 21 21 1 21 2 11 1 21 6 22 22 4 21 21 21 21 21 21 21 9 21 21 121 9 21 21 11 21 21 1 21 5 21 2 21 21 21 21 21 21 21 21 21 21 21 121 11 21 21 9 21 3 22 
5 21 21 21 21 21 21 21 21 21 21 6 22 22 22 22 4 21 21 21 3 22 22 22 22 21 21 21 21 21 6 5 21 21 21 21 6 22 4 21 21 21 21 3 22 22 22 5 21 21 21 21 21 21 21 21 21 21 21 21 21 6 22 22 22 4 21 21 21 21 21 1 21 21 21 21 21 21 21 21 21 21 21 21 6 22 5 21 21 21 21 21 21 21 21 21 21 21 21 21 21 21 21 21 21 21 6 
